NO ./textures/brick.xpm
SO ./textures/night.xpm
WE ./textures/metal.xpm
EA ./textures/wood.xpm
S ./textures/barrel.xpm
F 34,139,34
C 30,144,255

111111111111111111111111111111111
100000000000011100000000000000001
10000000000001S100000002000000001
100010000000000000000000000000001
100000000000100000011100002000001
10000020000010000001 100000000001
100000000000000000011100000000001
100000000000000000000000000000001
111111111111111111111111111111111